1111111111111
1001000CCCCC1
1000011111C01
1P0011E00C001
1111111111111