1111111111111111111111111111111111111
1P0000E000000000000000000000000000001
10000000000000000C000000000000000C001
10101010101010101010101010000C0000111
1000000000000000000000101111111111111
100000000000C000000000101111111111111
100000100000C000000000101111111111111
100000000000C000000000101111111111111
100000000000C000000000101111111111111
100000000000C000000000101111111101111
100000000000C000000000101111111111111
1000000000000000000000101111111111111
1111111111111111111111111111111111111