1111111111111
1001000CCCCC1
1000011111C01
1P011E00C0011
1111111111111