11111111111111
1111111111111C
111111111111112222
11111111111111
11111111111111
11111111111111wwwww