1111111111111111111111111111111
100100P000001000000000000000001
1000011111001000111111111111001
1100111100000100110000000000001
1111111111111111111111111111111
10000000000000001C0000000000001
1111111111111111111111111111111
10010010E0001000000000010000111
1000011111001000111111111111001
1100110000001001010000000000001
1111111111111111111111111111111