1111111111111111111111111111111
100100P000001000000000000000001
100001111100C000111111111111001
1100111100000100110000000000001
111111111111111111111101111C111
1000000000000000CC0000000000001
1111C11111111111111111111111111
100100C0E0001000000000010000111
100001C111001000111111111111001
11001100000C1001010000000000001
1111111111111111111111111111111