1111111
111C001
101C101
1P101E1
1111111