111111111
111100111
1CC100C11
1E0001P11
111111111