111111111
111100111
1C0100C11
1E0001P11
111111111