1111111111111111111111111111111
1C0100P000001000000000000000001
110101111100C000111111111111001
1101111100000100110000000000001
11C1111111111111111111C1111C111
1000000000000000CC0000000000001
1111C11111111111111111111110111
1001CCCC0ECC0100000000001000011
111101C0111C1000111111111111001
110011C0C00C10010100000000000C1
1111111111111111111111111111111