11111111111
1E1PC100001
11111111111