11111111111111111111111111111111111111
1E1000000000000C00000C0000000000010111
10100101001000001010010000000101010111
10100100101010100010010000000101010111
1P0000000C00C0000000000000000001C10111
11111111111110111111111111111111110111
11111111111110111111111111111111110111
1C1000000000000C00000C0000000000010111
10100101001000001010010000000101010111
10100100101010100010010000000101010111
100000000C00C0000000000000000001C10111
11111111111111111111011111111111110111
1C1000000000000C00000C0000000000001111
10100101001000001010010000000101101111
10100100101010100010010000000100101111
100000000C00C000000000000000001C101111
11111111111111111111111111111011101111
10100101001000001010010000001010100111
10100100101010100010010000001010101111
11111111111111111111111111111111111111